[
    [  0,  0,  0,  0,  0,  0,  0,  0,  0,  0,  0,  0,  0,  0,  0,  0,  0,  0,  0,  0,  0,  0,  0,  0,  0,  0,  0,  0,  0,  0,  0,  0,  0,  0,  0,  0,  0],
    [  0,  0,  0,  0,  0,  0,  0,  0,  0,  0,  0,  0,  0,  0,  0,  0,  0,  0,  0,  0,  0,  0,  0,  0,  0,  0,  0,  0,  0,  0,  0,  0,  0,  0,  0,  0,  0],
    [  0,  0,  0,  0,  0,  0,  0,  0,  0,  0,  0,  0,  0,  0,  0,  0,  0,  0,  0,  0,  0,  0,  0,  0,  0,  0,  0,  0,  0,  0,  0,  0,  0,  0,  0,  0,  0],
    [  0,  0,  0,  0,  0,  0,  0,  0,  0,  0,  0,  0,  0,  0,  0,  0,  0,  0,  0,  0,  0,  0,  0,  0,  0,  0,  0,  0,  0,  0,  0,  0,  0,  0,  0,  0,  0],
    [  0,  0,  0,  0,  0,  0,  0,  0,  0,  0,  0,  0,  0,  0,  0,  0,  0,  0,  0,  0,  0,  0,  0,  0,  0,  0,  0,  0,  0,  0,  0,  0,  0,  0,  0,  0,  0],
    [  0,  0,  0,  0,  0,  0,  0,  0,  0,  0,  0,  0,  0,  0,  0,  0,  0,  0,  0,  0,  0,  0,  0,  0,  0,  0,  0,  0,  0,  0,  0,  0,  0,  0,  0,  0,  0],
    [  0,  0,  0,  0,  0,  0,  0,  0,  0,  0,  0,  0,  0,  0,  0,  0,  0,  0,  0,  0,  0,  0,  0,  0,  0,  0,  0,  0,  0,  0,  0,  0,  0,  0,  0,  0,  0],
    [  0,  0,  0,  0,  0,  0,  0,  0,  0,  0,  0,  0,  0,  0,160,161,161,161,161,161,161,161,162,  0,  0,  0,  0,  0,  0,  0,  0,  0,  0,  0,  0,  0,  0],
    [  0,  0,  0,  0,  0,  0,  0,  0,  0,  0,  0,  0,  0,  0,177,177,177,177,177,193,177,177,178,  0,  0,160,  0,  0,  0,  0,  0,  0,  0,  0,  0,  0,  0],
    [  0,  0,  0,  0,  0,  0,  0,  0,  0,  0,  0,  0,  0,  0,177, 67,177,193,194,  0,192,177,177,194,  0,  0,  0,  0,  0,  0,  0,  0,  0,  0,  0,  0,  0],
    [  0,  0,  0,  0,  0,  0,  0,  0,  0,  0,  0,  0,  0,  0,192,193,194,  0,  0,  0,  0,192,194,  0,160,194,  0,  0,  0,  0,  0,  0,160,194,  0,  0,  0],
    [  0,  0,  0,  0,  0,  0,  0,  0,  0,  0,  0,  0,  0,  0,  0,  0,  0,  0,  0,  0,  0,  0,  0,  0,  0,  0,  0,160,162,  0,  0,  0,  0,  0,  0,  0,160],
    [  0,  0,  0,  0,  0,  0,  0,  0,  0,  0,  0,  0,  0,  0,  0,  0,  0,  0,  0,  0,  0,  0,  0,  0,  0,  0,  0,177,177,194,  0,  0,  0,  0,  0,  0,177],
    [160,162,  0,  0,  0,  0,  0,  0,  0,  0,  0,  0,  0,  0,  0,  0,  0,  0,  0,  0,  0,  0,  0,  0,  0,  0,  0,192,194,  0,160,161,162,  0,  0,  0,177],
    [176,177,162,  0,  0,  0,  0,  0,  0,  0,  0,  0,  0,  0,  0,  0,  0,  0,  0,  0,  0,  0,  0,  0,  0,  0,  0,  0,  0,  0,192,194,  0,  0,  0,160,177],
    [176, 67,178,  0,  0,  0,  0,  0,  0,  0,  0,  0,  0,  0,  0,  0,  0,  0,  0,  0,  0,  0,  0,  0,  0,  0,  0,  0,  0,  0,  0,  0,  0,160,162,177,177],
    [176,177,177,161,161,162,  0,  0,160,161,161,161,177,177,161,161,161,161,161,161,161,161,161,161,161,161,161,161,161,161,161,161,161,177,177,118,177],
    [176,177,177,177,177,177,177,177, 66,177,177,177,177,177,177,177,177,177,177,177,177,177,177,177,177,177,177,177,177,177,177,177,177,177,177,177,177],
    [176,177,177,177,177,177,177,177, 82,177,177,177,177,177,177,177,177,177,177,177,177, 67,177,177,177,177,177,177,177,102,177,177,177,177,177,177,177],
    [192,193,193,193,193,193,193,193,193,193,193,193,193,193,193,193,193,193,193,193,193,193,193,193,193,193,193,193,193,193,193,193,193,193,193,193,194]
]
